BCBhypofraprostateIMRT.json	BCB - hypofrac prostate, IMRT
Bradley3FxSBRTlung.json	Bradley_3 Fx_SBRT_lung
BradleyEsophagus.json	Bradley.Esophagus
BreastOnlyGlobal.json	Breast Only Global
BreastSCVLNboost.json	Breast_SCV LN boost
CNEBreastTangent.json	CNE-BreastTangentMDD
CNS1fGK.json	CNS_1fGK
CNS5fSRS.json	CNS_5fSRS
CNSHAWBRT.json	CNS_HAWBRT
CNSHGG.json	CNS_HGG
CNSIMRT6wk.json	CNS_IMRT6wk
CNSProton.json	CNS_Proton
CNSWBRT.json	CNS_WBRT
ComprehensiveAdjuvantXRTforBREASTCANCERviaIMRT.json	Comprehensive Adjuvant XRT for BREAST CANCER via IMRT
ComprehensiveAdjuvantXRTforBREASTCANCERviaIMRTGlobal.json	Comprehensive Adjuvant XRT for BREAST CANCER via IMRT Global
CTCBreastMultiport.json	CTC - Breast Multiport
CTCCWSCV.json	CTC - CW + SCV
CTCDIBHChestwallscv.json	CTC DIBH Chestwall/scv
CTCEsophagusIMRT.json	CTC - Esophagus IMRT
CTCIMRTLung.json	CTC-IMRT Lung
CTCProstateSVLN.json	CTC - Prostate/SV/LN
CTCSBRTLung3Fx.json	CTC - SBRT Lung 3Fx
CTCSBRTLung5fx.json	CTC - SBRT Lung 5 fx
CTCSpine2D.json	CTC - Spine 2D
CTCWholeBrain.json	CTC - WholeBrain
DalyLeftBreast3DCNE.json	Daly_LeftBreast3DCNE
GIAnalCancerSupine.json	GI - Anal Cancer Supine
GILiverSBRTAdaptive.json	GI - Liver SBRT Adaptive
GIPancreasPostop.json	GI - Pancreas Postop
GIRectumShortCourseIMRTBoost.json	GI - Rectum Short Course IMRT Boost
GUbladderIMRT.json	GU-bladder IMRT
GUconventionalWPintact.json	GU-conventional_WP_ intact
GUhypofrac.json	GU-hypofrac
GUpostopbedplusnodes.json	GU-post-op bed plus nodes
HallBladder.json	Hall - Bladder
HNAPAArm3.json	H&N APA Arm3
HNbilateral.json	H&N bilateral
HNDefinitive.json	H&N Definitive
HNPostop66.json	H&N Postop 66
MATLymphomamediastpossibleproton.json	MAT - Lymphoma, mediast, possible proton
None.json	None
PARTIQoLTrial.json	PARTIQoL Trial
ProstateHighRisk.json	Prostate_High_Risk
RoachLung15fxIMRT.json	Roach - Lung 15 fx IMRT
ROBINSONHEART1fx.json	ROBINSON - HEART - 1 fx
ROBINSONLUNG12fx.json	ROBINSON - LUNG - 12 fx
ROBINSONLUNG30fx.json	ROBINSON - LUNG - 30 fx
ROBINSONLUNG3fxSBRT.json	ROBINSON - LUNG - 3 fx SBRT
ROBINSONLUNG5fxSBRT.json	ROBINSON - LUNG - 5 fx SBRT
ROBINSONSPINE5fx.json	ROBINSON_SPINE_5 Fx
ROBINSONSPINE5fx.json	ROBINSON - SPINE - 5 fx
SPRAKER_LatticeSBRT.json	SPRAKER_Lattice_SBRT
SprakerLung15Fx.json	Spraker_Lung_15Fx
SPRAKERSARCPOSTOP60.json	SPRAKER_SARC_POSTOP_60
StageIIIlung.json	Stage III lung
UndefinedTemplate.json	Undefined Template
VlacichHypofracBreastIMRT.json	Vlacich_HypofracBreastIMRT
DefinitiveHN.json	Definitive H&N
TBI.json	TBI
SprakerExtSarcPreOp25Fx.json	Spraker_ExtSarc_PreOp_25Fx
CTCHNJL.json	CTC - H&N JL
CTCSBRTLung3fraction.json	CTC SBRT lung 3 fraction
GUEBRTpriortobrachyboost.json	GU-EBRT prior to brachy boost
GULDRcomboboost.json	GU-LDR combo boost
CTCSRS.json	CTC - SRS
CTCheadneckSJL.json	CTC head & neck SJL
BreastWhole.json	Breast_Whole
CTCIntRiskProstate.json	CTC - Int Risk Prostate